accidental=tesadüfi
intentional=kasıtlı
presentation=sunum
stare=dik dik bakmak
due=vadesi dolmuş
scarce=kıt
tendency=eğilim
process=süreç
ancestor=ata
fit in=uyum sağlamak
adopt=evlat edinmek
basket case=işe yaramaz
self sufficient=bağımsız
coincidence=tesadüf
notable=dikkate değer
mention=bahsetmek
lack=yokluk
annual=yıllık
decade=onyıl
instant=anlık
refer=bahsetmek/değinmek
distribute=dağıtmak
spread=yayılmak
stripe=çizgi
arctic=buz gibi
leakage=sızıntı
coral=mercan
pond=gölet
concrete=beton
shape=şekil
blend in=uyumlu olmak/karışmak
stand out=dikkat çekmek
shade=renk tonu
consistent=tutarlı
alleviate=hafifletmek,kısmen gidermek
courtesy=nezaket
owe=borçlu olmak
wage=ücret
circumstances=koşullar
tear up = yırtıp atmak
occasional=nadiren
doubt=şüphelenmek/şüphe
doubtful=şüpheli
grievance=sıkıntı sebebi
mind-boggling=akıl durgunluk veren
on point=isabetli
upper hand=üstün
persuade=ikna etmek
abdomen=karın
detrimental=zararlı
humidity=nem
pneumatic=havalı (system)
encounter a problem=bir sorunla karşılaşmak
insulation=yalıtım
azimuth=istikamet açısı
infrastructure=altyapı
embrace=kucaklamak,bir teklifi kabul etmek
constellation=takımyıldız
threshold=eşik
deviation=sapma
distortion=bozukluk
arbitrary=gelişigüzel
compensate=telafi etmek
worsen=kötüleşmek
harnesses=donanım
preposition=edat