Accidental - TesadÅfi
òntentional - Kasçtlç
Presentation - Sunum
Scarce - Kçt
Tendency - Eßilim
Process - SÅreá
Ancestor - Ata
Coincidence - TesadÅf
Mention - Bahsetmek
Lack - Yokluk
Annual - Yçllçk
Decade - Onyçl
Instant - Anlçk
Refer - Bahsetmek
Distribute - Daßçtmak
Spread - Yayçlmak
Stripe - Äizgi
Leakage - Sçzçntç
Coral - Mercan
Pond - Gîlet
Concrete - Beton
Shape - ûekil
Consistent - Tutarlç
Courtesy - Nezaket
Wage - öcret
Circumstances - Koüullar
Occasional - Nadiren
Doubt - ûÅphelenmek
Doubtful - ûÅpheli
Abdomen - Karçn
Detrimental - Zararlç
Humidity - Nem
Pneumatic - Havalç
Insulation - Yalçtçm
Infrastructure - Altyapç
Embrace - Kucaklamak
Constellation - Takçmyçldçz
Threshold - Eüik
Deviation - Sapma
Distortion - Bozukluk
Arbitrary - GeliüigÅzel
Worsen - KîtÅleümek
Harnesses - Donançm
Preposition - Edat
Basket Case - òüe Yaramaz
Congratulations - Tebrikler
Paper - Kaßçt
Mouse - Fare
Television - Televizyon
Soccer - Futbol
Ball - Top
Coffee - Kahve
Try - Denemek
shape - üekil
